10
10
##########
#--------#
#--------#
#--------#
#--------#
#--------#
#--------#
#--------#
#++++++++#
#++++++++#
##########