30
30
##############################
#----------------------------#
#----------------------------#
#----------------------------#
#---------++++++++-----------#
#---------++++++++-----------#
#---------++++++++-----------#
#---------++++++++-----------#
#---------++++++++-----------#
#----------------------------#
#----------------------------#
#----------------------------#
#---------------------+++++++#
#---------------------+++++++#
#---------------------+++++++#
#---------------------+++++++#
#---------------------+++++++#
#----------------------------#
#----------------------------#
#----------------------------#
#+++++++---------------------#
#+++++++---------------------#
#+++++++---------------------#
#+++++++---------------------#
#+++++++---------------------#
#----------------------------#
#++++++++++++++++++++++++++++#
#++++++++++++++++++++++++++++#
##############################
