20
20
####################
#------------------#
#++++++++----------#
#------------------#
#------------------#
#------------------#
#------------------#
#---------+++++++++#
#------------------#
#------------------#
#------------------#
#------------------#
#+++++++++---------#
#------------------#
#------------------#
#------------------#
#-------++++++++++-#
#------------------#
#------------------#
#------------------#
####################